##############################
#~~~~~~~~~~~~~~~~~~~~~~~~~~~~#
#~+~~~ *              * ~~~+~#
#~~~~        =  =        ~~~~#
#~~~       +======+       ~~~#
#~~    ==     xx     ==    ~~#
#~    ==     xxxx    *==    ~#
#~  #=====# xxxxxx #=====#  ~#
#~    ==*    xxxx     ==    ~#
#~~    ==     xx     ==    ~~#
#~~~       +======+       ~~~#
#~~~~        =  =        ~~~~#
#~+~~~ *              * ~~~+~#
#~~~~~~~~~~~~~~~~~~~~~~~~~~~~#
##############################
