##############################
#~~~~~~~~~~~~~~~~~~~~~~~~~~~~#
#~~~~~~~~~~~~~~~~~~~~~~~~~~~~#
#~~~~~~~~~~~~~~~~~~~~~~~~~~~~#
#~~+=~~~~~~~~~ ~~~~~~~~~=++~~#
#xxxxxxxxx++++=*~ xxxxxx *=  #
#======*====~  xxxxxx  +     #
#+=   ====  ~                #
#=           ~               #
#xx*         *      +        #
#xxxx        *            =  #
#xxxxxxxxx   ~~     ~    =+= #
#~~xxxxxx* * ~   ~        =  # 
#~~~~~~~~~~~~~~~~~~~~~~~~~~~~#  
##############################
