####################
#   =       =      #
# *     =   =    * #
#   #   =   =  ~~~ #
#===#   =   =  ~~~ #
#   =           =  #
#   #  ===         #
#        =   =     #
#   #x   =  ==  +  #
#   #xxx           #
#   #xxxx#         #
# * =xxxx# *     * #
#   =xxxx#         #
####################
