##############################
#   =       =       =        #
# *     =   =    *  =  * =   #
#   #   =   =  ~~~  =   =+=  #
#===#   =   =  ~~~  =xx  =   #
#   =           =   =xxx   * #
#   #  ===          =xxx     #
#        =   ==========#     #
#        =   =       =       #
#   #x   =   =  +    =    +  #
#   #xxx             +       #
#   #xxxx#              ~~~~~#
# * =xxxx# *     +     ~~~~~~#
#   =xxxx#            ~~~+~~~#
##############################
